1 0 2 0 1 1 1 1 1 1 1 1 1 1 1 1
1 0 2 0 3 5 0 0 0 0 0 0 0 0 0 1
1 0 2 0 7 0 0 0 0 3 5 0 0 0 0 1
1 0 2 0 0 0 0 0 0 7 0 0 0 0 0 1
1 0 2 0 0 0 0 0 0 0 0 0 0 0 0 1
1 0 2 0 0 0 0 0 0 0 0 0 0 0 0 1
1 0 2 2 2 2 2 2 2 2 2 2 2 2 2 1
1 0 0 0 0 0 0 0 0 0 0 0 6 0 0 1
1 0 3 5 0 9 10 0 0 0 0 0 0 0 0 1
1 0 7 0 0 11 12 0 0 3 5 0 0 0 0 1
1 0 0 0 0 0 0 0 0 7 0 0 0 0 0 1
1 1 1 1 1 1 1 1 1 1 1 1 1 1 1 1