0 0 0 7 0 0 0 0 8 3 5 3 5 3 5 3
0 0 0 0 0 0 0 0 9 2 4 2 4 0 6 2
0 0 0 0 0 0 0 0 8 3 5 3 5 0 0 3
0 0 0 0 0 0 0 0 0 0 0 0 0 0 0 0
0 0 0 0 0 0 0 0 8 2 4 8 0 2 4 2
0 0 0 0 0 0 0 0 9 3 5 9 0 3 5 3
0 0 0 0 0 0 0 0 0 0 0 0 0 0 0 0
0 0 0 0 0 0 0 0 8 2 4 2 4 8 0 2
0 0 0 0 0 0 0 0 9 3 5 3 5 9 0 3
0 0 0 0 0 0 0 0 0 0 0 0 0 0 0 0
0 0 0 0 0 0 0 0 8 2 4 2 4 2 4 2
0 0 0 0 0 0 0 0 9 3 5 3 5 3 5 3
